111111111111111111111111
100E00000000000000000001
11C11M111M1111MM11111101
1CCCCC11111CCCCCCCCC1111
1C0000000000000000000001
11CCCCCCCCCC111111111111
1MMMMCMMMM11111100000001
1MC000000000000000000MC1
10000000000P000000000001
111111111111111111111111
