11111111111111111
11000C00C0100E0C1
10M1001000M00C0M1
1MMM0001000C0C0M1
100010000010MC0C1
1000C00M00000C0M1
10000M000C010MM01
1C01M0CC0M010C001
1MMCMCMCMCMMMCMC1
1MC0CCCCCC0C00P01
11111111111111111

