111111111111111111111
100000000000000000001
1000000MCMCMCMC000001
101010101101011011011
100000000000000000001
100000000000011110001
111111000000000000001
1110000000000000E0001
1010000000P0000000001
111111111111111111111
