111111111111111111111111111111
1C01C0C0C0EC0C0C0C01C0C0C0C0C1
1C0C0C0M0C0C0C0C0C01C0M0C0C0C1
1C0C0C0C1C00000M00010000000001
100100000011100000010010000001
100CMCCMMCCCCM0000010000000011
1110000100001000000100C0C0C0C1
1C0C0C0CMC0C0C0C0C01C0100C0C11
1C0C0C001C0C0C0C0C00C0C0C00PC1
1C0C0C0C0C0C0C0C0C01C0C0C0C0C1
1C0101010101010101011010001011
11010C010101010101011010101011
110101010101101010011010101011
1101010101010101010110101C1001
110C0M010C0C0C0CCM01C000C1M0C1
111111111111111111111111111111