11111111111111111111111111111111111
100011000000000C00000E0000000000001
1MMCMMMMMMCMMMMMM000000C11111000001
1000CCCCC00010000000000100000100001
100000M0000100000000001000000010001
100000000010000000000C0000000100001
10000000010000000000000000001000001
10000000100000000000000000010000001
10000001000000000P00000000100000001
10000011111111100000000001000000001
10000000000000100000000010000000001
100000C0000000100000000100000000001
10000000000000100000000111111111001
11111111111111111111111111111111111