111111111111
100000000001
1000CCCC00E1
1C0000000P01
111111111111