11111111111111
1000C0E0000001
1C000000C00001
1M000000M11111
1000000C001111
10000000000001
1C00000C000001
100000000000C1
100000P0111111
11111111111111

