1111111111111111111
1000000000001000001
101010000PCE000CCC1
1000000000000000001
1010001010000010001
1110000010000000111
1CCC1100001000010C1
1000000000010001001
1111111111111111111

