111111111
1000C00P1
1000000M1
1000000M1
1000000M1
1000000M1
1000000M1
1000000M1
1000E00M1
111111111