1111111111111
1000000000001
10100M00000P1
100000C000001
1000000000001
1000000000001
1C00000000C01
1000000000001
1000000000001
10C0000000001
10000000000E1
1111111111111