11111111111111111
11C1111C1111111C1
11011110111111101
1100000P000000001
11111110111111111
11111110111111111
111111100E1111111
11111111111111111