111111111111111
1P00C00000C0001
100001011000M01
101110111111101
101000001000001
101011101111001
1C00000000E0001
111111111111111