	111111111111111111111111
	10000000000C0000000C0001
	10P000000000000M00000001
	10P000000000010M00010001
	10P00000C000000M00000011
	10P000000000000M00000MC1
	111111111111111111111111